...######.........................
...#....#.........................
...#....#.........................
...#....#.........................
...####.#.........................
......#.#######...................
......#.......#...................
......#######.#...................
............#.#...................
............#.#...................
............#.#...................
............#.#...................
.....########.#######.............
.....#..............#.............
.....#..............#.............
.....#..............#.............
.....#..............#.............
.....################.............