####################
#..................#
#...www............#
#...www..###.......#
#...www.....#......#
#......###..#......#
#......##...#......#
#.......#...#......#
#.......#####......#
#..................#
#..................#
#..................#
#..................#
#..................#
####################